3  3 S    S 3      3
3Q 3        3 S    3
31 3   3    3    113
3  3   3    3      3
3  3   3    3      3
3  3   3    3    113
3  3   3    3      3
3  3 S 3    3 S    3
3  3   3    3    113
3  3   3    3      3
3  3   3    3    E 3
3  3   3    3    113
3    S 3      S    3
3      3           3
3      3           3
