11111111111111111111
3 Q  3  S     3   S3
3 S  3          S E3
3    3        3    3
3    3        3    3
3    3        3    3
3    3        3    3
3    3        3    3
3    3      S 3    3
3    3        3    3
3    3   S    3    3
3             3    3
3    S        3    3
3                  3
3                  3
