11111111111111111111
3 Q 3       3   E  3
3   3       3      3
3   3       3      3
3   3       3      3
3SSSSSSSSSSSSSSSSSS3
3                  3
3                  3
3                  3
3                  3
3                  3
3                  3
3                  3
3                  3
3                  3
