11111111111111111111
3                  3
3               E  3
3               1113
3                  3
3                  3
3                  3
3                  3
3                  3
3                  3
3                  3
3             S    3
3             S    3
3   Q         S    3
111111             1
