    
   
    
11111111111111111111
3                  3
3                  3
3                  3
3                  3
3 Q                3
3                  3
322   V   V   V  E 3
11111111111111111111
 3                3
 3                3
 3                3
