11111111111111111111
3 Q                3
3                  3                  
3          V       3
3111111111111      3
3                  3
3  22    V     V   3
3  11111111111111113
3                  3
3                  3
3  V    V    V     3
31111111111111111  3
3                  3
3SE      V   V   V 3
11111111111111111111
