44444444444444444444
3 S                3
3   E        V     3                  
3111111      3     3
3            3  S  3
3                  3
3                  3
3            V   V 3
3         S 11111113
3 S         3      3
3 V         3      3
31111       3      3
3                  3
3               Q  3
1             111111
