 
 
 
 
44444444444444444444
3                  3
3                  3
3                  3
3                  3
3 Q                3
3                  3
322             E  3
1111111 1111   11111
 3                3
 3                3
 3                3
