 
 
 
44444444444444444444  
2                  2
2                  2
2                  2
2                  2
2                  2
2  Q               2
2             S E  2
111111        111111
 
