444444        444444
3                  3
3                  3
3       S          3
3  E               3
3111111111   S     3
3     6            3
3     6      1111113
3     6  S         3
3     1111         3
3                  3
3   Q              3
3          222     3
3     11111111     3
11111115555555111111
