11111111111111111111
3                  3
3                  3
3                  3
3   S              3
3   S              3
3   S              3
3                  3
3                  3
311   11111111111113
3                E 3
3          222222223
3          222222223
3   Q      222222223
11111111111111111111
