11111111111111111111
3                  3
3                  3
3        S      E  3
3           11111113
3                  3
3                  3
3               1113
3                  3
3                  3
3                 13
3   Q              3
3                  3
3                  3
11111111111111111111
