11111111111111111111
3         S        3
3       11111      3
3 S       3        3
3         3        3
3         3        3
3         3        3
3         3        3
3         3        3
3         3        3
3         3        3
3         3        3
3   Q     3        3
3         3     E  3
11111111111111111111
