11111111111111111111
3        S   E     3
3        S         3
3        S         3
3        S         3
3        S         3
3        S         3
3        S         3
3        S         3
3        S         3
3        S         3
3        S         3
3        S         3
3  Q     S         3
11111111111111111111
