 
 
 
22222222222222222222  
2                  2
2        S         2
2 E                2
21111111111    S   2
2     3            2
2     3  S         2
2 Q                2
1111111            1
