11111111111111111
1               1
1  Q   111      1
1               1
1          111111
1               1
1  1111         1
1 1    11       E
11111111111111111
11111111111111111
